**** ****
***  ****
*** *****
***    **
*** ** **
****** **